1111111111
1000000001
1111111101
1000000001
1011111111
1000000001
1111111101
1000000001
1011111111
1111111111

